N N N N N N E N N
E N N N N N E N N
X N N N N N X X X
X N N N N N X X X
X N N N N N X X X
X E E E E E X X X